26
50 85 38 45 88 93 62 93 51 47 21 71 51 46 34 97 96 77 72 22 62 38 49 16 56 75
55 69 38 68 52 23 97 66 77 98 35 12 14 65 93 92 80 28 25 26 72 55 79 14 97 32
40 78 26 45 88 28 31 76 85 88 64 51 55 75 87 11 82 18 89 83 75 41 10 74 12 61
80 37 63 81 94 64 57 74 12 64 43 69 85 38 18 52 100 16 31 16 85 65 100 41 93 36
42 27 41 78 48 91 69 10 24 68 74 65 20 86 19 57 28 95 57 13 47 86 55 21 96 88
32 99 42 98 36 59 81 73 50 87 16 73 58 76 73 79 64 38 43 29 72 44 55 76 41 83
20 78 50 73 45 71 41 29 100 30 33 70 91 74 29 35 87 25 98 12 43 27 80 94 13 37
96 40 67 77 43 93 90 90 99 57 95 96 46 11 63 71 96 43 32 44 82 63 38 59 47 15
67 14 96 25 12 24 25 84 95 68 47 79 39 58 92 90 89 78 77 38 74 11 61 75 96 39
32 33 65 95 89 17 88 38 16 53 43 23 53 87 86 37 85 90 59 29 30 75 13 47 80 34
23 40 32 75 19 62 58 23 23 80 18 35 22 78 71 45 47 33 26 34 43 50 98 74 84 66
65 49 90 17 68 26 43 15 55 82 84 79 45 56 66 55 10 51 71 90 69 47 51 94 85 45
15 61 30 94 73 87 89 21 91 22 80 25 44 59 68 67 25 13 73 60 80 57 41 14 51 84
24 21 35 14 34 90 59 27 37 51 76 17 43 28 83 80 24 13 77 32 93 44 96 72 60 100
19 66 40 22 85 30 67 80 61 45 99 24 38 33 19 19 38 29 38 42 46 36 29 63 96 95
90 74 58 52 44 55 100 52 44 54 46 17 86 68 79 34 44 37 96 52 36 63 21 45 28 15
30 38 43 85 91 15 42 63 83 52 72 95 70 17 15 68 77 46 93 13 99 26 37 72 10 84
58 44 12 100 97 38 36 65 52 35 88 83 27 43 64 53 45 51 61 14 31 79 53 89 27 15
93 87 23 82 72 49 87 59 68 63 70 64 89 95 43 42 40 48 94 42 49 56 95 93 30 62
86 84 38 79 37 92 45 89 46 47 97 67 56 76 35 47 88 94 28 76 14 44 34 27 54 44
20 16 26 57 41 56 16 86 56 67 30 88 26 65 78 12 31 84 40 20 44 36 59 54 16 60
31 15 44 18 91 70 38 37 71 56 40 82 57 72 94 23 34 85 16 41 73 75 38 84 97 41
16 49 86 61 76 12 44 27 53 65 53 16 81 68 56 29 14 35 36 70 52 73 31 30 33 62
81 91 98 21 81 26 86 56 23 90 13 69 58 16 83 64 92 10 84 36 21 13 87 75 86 100
39 12 60 29 26 46 62 24 71 64 93 83 64 43 16 23 10 58 29 67 13 71 29 46 51 32
84 68 13 79 94 62 48 82 88 39 26 66 56 87 33 53 42 96 18 47 25 22 16 11 91 91
